48
48
23 23 23 23 23 23 23 23 23 23 23 23 23 23 23 23 23 23 23 23 23 23 23 23 23 23 23 23 23 23 23 23 23 23 23 23 23 23 23 23 23 23 23 23 23 23 23 23
23 6  2  2  1  1  5  26 26 1  1  1  1  1  2  1  1  26 1  1  1  1  1  1  1  1  1  1  1  1  1  1  1  1  1  24 1  1  1  1  1  1  1  1  1  1  1  23
23 1  1  2  1  1  1  26 26 1  1  2  1  1  1  1  5  26 1  1  1  1  1  1  1  1  1  1  1  1  1  5  1  5  1  24 1  1  1  1  1  24 1  1  1  1  1  23
23 1  2  1  1  1  1  26 26 1  1  1  2  2  1  1  1  26 1  1  1  24 24 24 24 24 1  1  1  1  1  1  1  24 24 24 1  1  1  1  1  24 24 24 24 24 1  23
23 1  1  26 26 26 26 26 26 2  1  26 26 26 26 26 26 26 1  1  1  24 1  1  1  24 26 2  2  26 26 1  1  24 1  1  1  1  1  1  1  24 1  1  1  24 1  23
23 1  1  1  1  1  1  1  1  1  1  1  1  1  24 1  1  1  1  1  2  24 1  1  2  24 1  1  1  1  26 1  1  24 1  1  24 24 24 24 24 24 1  1  1  24 1  23
23 1  1  1  1  2  1  5  1  2  1  1  1  1  24 1  1  1  1  1  1  26 1  1  24 24 1  1  1  1  26 26 26 26 1  24 24 1  1  1  1  1  1  1  1  24 1  23
23 1  1  26 1  1  1  1  1  1  1  24 24 1  24 1  1  1  26 26 26 26 1  24 5  26 1  1  1  26 26 1  1  26 1  1  24 1  1  1  1  1  1  1  1  24 1  23
23 5  1  26 1  1  2  2  1  26 1  24 24 24 24 24 1  26 1  1  1  1  1  1  26 26 26 26 26 26 1  1  1  26 1  1  24 1  1  1  1  26 26 26 1  1  1  23
23 1  2  26 1  1  1  1  1  26 1  26 1  1  1  1  1  1  26 1  1  1  1  1  1  26 1  1  26 26 1  1  1  26 1  1  24 1  1  1  1  26 1  26 26 26 26 23
23 2  1  26 1  1  1  1  2  26 1  26 1  1  1  1  1  1  26 1  1  1  1  1  1  26 1  1  1  1  1  1  1  1  1  1  24 1  1  26 26 26 1  1  1  1  1  23
23 1  2  26 2  2  1  1  1  26 1  26 1  1  26 26 26 26 26 1  1  1  1  1  2  26 1  1  1  1  26 1  1  1  1  24 24 24 1  26 1  1  1  1  1  1  1  23
23 1  2  26 26 1  2  1  1  26 26 26 1  1  26 1  1  1  1  1  1  1  1  1  1  26 26 26 26 26 26 1  1  1  1  1  1  1  1  26 1  1  1  1  1  1  1  23
23 1  1  1  26 1  1  1  1  1  1  26 1  1  26 1  1  1  1  1  1  1  1  1  1  26 1  1  1  1  1  1  24 1  1  24 1  26 26 26 1  1  1  1  1  1  1  23
23 1  2  26 26 1  1  2  1  1  1  5  1  1  1  1  1  1  1  1  1  1  1  1  1  21 2  1  1  1  1  1  26 1  24 24 26 26 1  1  1  1  1  1  1  1  1  23
23 1  1  26 1  1  1  2  2  1  1  26 1  1  1  1  1  1  1  1  1  1  1  1  1  26 1  1  2  26 26 1  24 1  24 1  1  1  1  1  1  26 26 26 1  1  1  23
23 2  1  26 1  5  1  1  1  1  5  26 1  1  1  1  1  1  1  1  1  1  1  1  1  26 1  1  1  26 1  1  1  1  24 1  1  1  1  1  1  26 1  26 1  1  1  23
23 1  1  26 1  1  26 26 26 26 26 26 1  1  1  1  1  1  1  1  1  1  1  1  1  26 26 26 26 26 1  2  1  1  24 1  1  1  1  1  1  26 1  26 26 26 26 23
23 1  2  26 1  1  26 1  1  1  1  26 1  1  1  1  1  1  1  1  1  1  1  1  1  26 1  1  1  2  1  1  24 24 24 1  1  26 26 26 26 26 1  1  1  1  1  23
23 1  1  26 2  1  26 1  1  1  1  26 1  1  1  1  1  1  1  1  1  1  1  1  1  26 1  1  1  1  1  1  24 1  1  1  1  1  1  1  1  1  1  1  1  1  1  23
23 2  1  26 1  1  26 1  1  1  1  26 1  1  1  1  1  1  1  1  26 26 21 26 26 26 1  2  1  24 24 24 24 1  1  1  1  1  1  26 1  1  1  1  1  1  1  23
23 26 26 26 1  1  24 1  26 26 26 26 1  1  1  1  1  1  1  1  26 1  1  26 26 1  1  1  1  24 1  1  1  1  1  1  1  1  1  26 1  1  1  1  1  1  1  23
23 1  1  1  1  1  24 1  1  26 1  1  1  1  1  26 26 26 26 26 26 1  1  26 26 2  2  1  1  24 1  1  26 26 26 26 26 1  1  26 1  1  1  1  1  1  1  23
23 1  1  1  2  24 24 1  1  26 1  1  1  1  26 26 26 1  1  26 1  1  1  26 26 1  1  1  1  24 1  1  26 1  1  1  26 1  1  26 1  1  1  1  1  1  1  23
23 1  5  1  1  1  24 24 1  24 1  1  1  1  26 26 26 1  1  26 1  26 1  26 24 24 2  24 24 24 1  1  26 1  1  1  26 26 26 26 1  1  1  1  1  1  1  23
23 1  1  1  1  1  24 1  1  24 1  1  1  1  26 1  1  1  26 26 1  26 1  26 1  1  1  24 24 1  1  1  1  1  1  1  26 1  1  26 1  1  1  1  1  1  1  23
23 1  1  1  1  1  24 1  1  1  1  1  1  1  26 1  1  1  26 1  1  1  26 26 1  1  1  24 24 1  1  1  1  1  1  1  26 1  1  26 1  1  1  1  1  1  1  23
23 1  1  2  1  1  24 1  1  1  1  1  1  1  1  1  1  1  1  1  1  26 26 1  1  1  1  1  24 1  1  1  26 1  1  1  26 1  1  26 26 26 26 1  1  1  1  23
23 1  1  1  1  1  24 1  1  24 24 24 24 24 1  1  1  26 26 1  1  1  26 26 1  1  1  1  24 1  1  26 26 1  1  1  26 1  1  1  1  1  26 1  1  1  1  23
23 24 24 24 24 24 24 1  1  24 5  5  5  24 1  1  1  26 1  1  1  1  26 1  1  1  1  24 24 1  1  26 1  1  1  1  26 1  1  1  1  1  26 26 1  1  1  23
23 1  1  1  24 1  1  1  1  24 24 24 24 24 26 1  1  26 1  1  26 26 26 26 1  1  1  24 24 26 26 26 1  1  1  1  26 1  1  1  1  1  1  26 26 1  1  23
23 1  24 1  26 1  24 24 24 24 1  1  1  1  26 26 26 26 26 2  26 1  1  26 26 26 1  1  1  1  1  1  1  1  1  1  26 1  1  1  1  1  1  1  26 1  1  23
23 1  1  1  26 26 1  1  1  1  1  26 1  1  1  1  1  1  1  1  26 1  1  1  1  26 1  1  24 1  1  1  1  1  1  26 26 1  1  1  1  1  1  1  26 26 26 23
23 1  1  1  1  26 1  5  1  26 26 26 1  1  1  1  5  1  1  1  26 26 26 1  1  26 1  1  24 1  1  1  1  1  26 26 1  1  1  1  1  1  1  1  1  1  1  23
23 1  1  1  1  26 1  1  1  1  1  26 1  1  1  1  1  1  1  1  1  1  26 1  1  26 1  1  24 1  1  1  1  1  26 1  1  1  1  1  1  1  1  1  1  1  1  23
23 1  1  1  1  26 1  1  1  26 26 26 1  1  26 1  1  1  1  1  1  1  26 1  26 26 1  1  24 24 24 26 26 26 26 1  1  1  1  1  1  24 24 24 24 24 1  23
23 1  1  24 1  1  1  26 1  26 1  1  1  1  1  26 26 1  1  26 26 1  26 1  1  26 1  1  1  1  1  26 5  5  26 1  1  1  1  1  1  24 1  1  1  1  1  23
23 1  1  26 26 24 1  1  1  26 1  1  1  1  1  1  26 26 1  1  1  1  1  1  1  26 1  1  1  1  1  1  5  5  26 1  1  1  1  1  1  24 1  1  24 1  1  23
23 1  1  24 1  1  1  1  1  26 1  1  1  1  1  1  26 1  1  1  1  1  1  1  26 26 1  1  1  1  1  26 5  5  26 1  1  1  1  1  1  24 1  1  24 1  1  23
23 1  1  1  1  26 1  1  1  26 1  1  1  1  1  1  26 1  1  1  26 26 26 1  1  26 1  1  1  1  1  26 5  5  26 1  1  1  1  1  1  24 1  1  24 1  1  23
23 1  1  1  1  24 1  26 26 26 26 26 26 1  1  1  26 1  1  1  26 1  26 1  1  26 1  1  1  1  1  26 26 26 26 1  1  1  24 24 24 24 1  1  24 24 24 23
23 24 24 5  24 26 1  1  1  26 1  1  26 26 1  1  26 26 1  1  1  1  26 1  1  26 26 26 1  1  1  1  1  26 1  1  1  1  1  1  1  24 1  1  1  1  1  23
23 1  1  1  1  24 1  1  1  26 1  1  1  1  26 1  1  26 1  1  1  1  26 1  1  26 1  26 1  1  1  1  1  26 1  1  1  1  1  1  1  24 1  1  1  1  1  23
23 1  1  1  1  26 26 26 26 26 1  1  1  1  1  1  1  26 26 26 26 1  26 26 26 26 1  26 26 1  1  1  1  26 1  1  1  1  1  1  1  24 1  1  1  1  1  23
23 1  1  1  1  1  1  1  1  26 1  24 2  1  1  1  1  1  26 24 1  1  1  1  1  1  1  1  26 26 1  1  1  1  1  1  1  1  1  1  1  24 1  1  1  1  1  23
23 1  1  1  1  1  1  1  1  26 1  1  24 1  1  1  1  1  26 1  1  1  1  1  1  1  1  1  1  26 26 1  1  1  1  1  1  1  1  1  1  24 1  1  1  1  1  23
23 1  1  1  1  1  1  1  1  26 1  1  1  1  1  1  1  26 26 24 1  1  1  1  1  1  1  1  1  1  26 26 1  1  1  1  1  1  1  1  1  24 1  1  1  1  1  23
23 23 23 23 23 23 23 23 23 23 23 23 23 23 23 23 23 23 23 23 23 23 23 23 23 23 23 23 23 23 23 23 23 23 23 23 23 23 23 23 23 23 23 23 23 23 23 23